11000011111100000000000-
01200010200100000000000-
01000010000100020000000-
01000010002111111100000-
01200210000000200100000-
01000010000000000100000-
01000010000000002100000-
01000210000111111100000-
01200010000100200000000-
01111110002100000000000-
00000000000100000000000-
00000000000100200000000-
00000000000111111111110-
00000000000000002000200-
00000000000000000000000-
00000000000000000000000