0	0	0	0	0	0
0	1	0	1	0	1
0	0	0	0	0	1	0	1	0	2	0	2	0	1	0	2	0	0
0	1	0	1	0	0	0	2	0	10	0	10
0	10	0	10	0	10	0	10
0	1	0	1	0	3	0	3	0	10	0	10	0	10	0	0	0	1	0	2	0	2	0	10	0	10
0	2	0	1	0	2	0	1	0	1	0	3	0	2	0	3	0	2	0	0	0	1	0	0	0	3	0	2	0	1	0	0
265	7	1