110111211110000-
012101010010000-
010121012010000-
010101210210000-
012101010210000-
011101110011110-
000000000000000-
000000000000000