11000011111100000000-
01200010200100000000-
01000010000100020000-
01000010002111111100-
01200210000000200100-
01000010000000000100-
01000010000000002100-
01000210000111111100-
01200010000100200000-
01111110002100000000-
00000000000100000000-
00000000000100200000-
00000000000111111100-
00000000000000002000-
00000000000000000000-
00000000000000000000