0	0	0	0	0	1	1	2	1	2	0	9	0	5	0	3	0	3	0	3	2	7	2	7
0	10	0	10	0	1	0	1	1	12	1	2	0	2	0	0	2	13	2	15	2	15	2	13	2	11
0	16	0	16	0	17	0	17	0	18	0	18
1	12	1	12	1	11	1	11	1	10	2	4	2	5	2	6	2	6	0	9	0	9	0	10	0	19
2	14	2	10	0	11	0	11	0	12	0	12	0	5	0	20
400	7	7